
SO ./xpm/wall_north.xpm
NO ./xpm/wall_north.xpm
EA ./xpm/wall_north.xpm
F 20,1,0
WE ./xpm/wall_north.xpm
C 0,0,0

11111111111111111111111111
1100000000000000000000001
1100000000000000000000001
1100000000000000000000001
1100000111110000000000001
1100000100010000000000001
1100000100010000000000001
1100000100010000000000001
1100000111000000000000001
1100000000000000000000001
1100000000010000000000001
1100000000010000000000001
1100000000010000000000001
1100000000010000000000001
1100000000010000000000001
1100000000010000000000001
1100000000010000000000001
1100000000010000000000001
1100000000000000000000001
1100000000000000000000001
1100000000000000000000001
11000000000000000000000011
110000000000000000001100101
1S011111111111111111111111
1111111111111111111111111
