F 0, 0    , 150   
C     150    ,     96,     4    
WE ./xpm/wall_north.xpm
SO ./xpm/wall_north.xpm
NO ./xpm/wall_north.xpm
EA ./xpm/wall_north.xpm


111110111   
10000111   
10000111   
100000E1   
01111111   
    