C 150,96,4
F 200,200,150

WE ./xpm/wall_north.xpm
SO ./xpm/wall_north.xpm
NO ./xpm/wall_north.xpm
EA ./xpm/wall_north.xpm











               1
1
1
                      111
1
1
1
1
1     1     1        1           1              1   1
  1
    1
      1          1                                                                                111111
1                                                                                                1000011
1                                                                                                1011001
1                                                                                                100N101
1                                                                                                 100001
      1                                                                                           1111111
                 111                 111                 111                 111                 111
                1001                1001                1001                1001                1001
                 111                 111                 111                 111                 111
                                                1
                 1                                  1

