F 0, 0    , 150   
C     150    ,     96,     4    
WE ./xpm/wall_north.xpm
SO ./xpm/wall_north.xpm
NO ./xpm/wall_north.xpm
EA ./xpm/wall_north.xpm


 111111111
1N000000001
 1111011101
    101 101
    101 101
    111  1
