F 0, 0    , 150   
C     150    ,     96,     4    
WE ./xpm/wall_north.xpm
SO ./xpm/wall_north.xpm
NO ./xpm/wall_north.xpm
EA ./xpm/wall_north.xpm

  1111111
  1000001
 11011101
 1101  1
10N01
 111
