WE ./xpm/wall_north.xpm
SO ./xpm/wall_north.xpm
NO ./xpm/wall_north.xpm
EA ./xpm/wall_north.xpm
C 76,137,166
F 48,44,52

111111
100101
101001
11N001
111111
